GWWGGGGGGG 
GWWGGGSGGG
GGWGGGSGGG
GSSSSSSGGG
GSGWWWWWGG
GSGGGWWWWG
GSGGGGWWGG
.....sOsss
.....t.t.s
.t.ttt...s
t......t.s
t.t......s
t.t......s
t.tsssssss
..........
..........
..........
........C.
..........
