SSS...S.SS 
GWWGGGSGGG
GGWGGGSGGG
GSSSSSSGGG
WWGWGWGW.W
GSGGGWWWWG
GSGGGGWWGG
